0000000000000000
0000000000000000
0000000000000000
0009000009000000
2000000000000000
1009000009000000
0000000000000000
0000000000000000
0080089008089000
0000000800000000
0000009000009099
3333333333331000
1111111111110000
0000000000019000
0000400000010800
0000100000019007
0800000000011301
0000000000000000
0000000000000000
0800000000000000
0000800080080080
0000000000000000
0000000000000000
0000000000000000