0000000000000000
0000000000000000
0000000000000000
0000000000000000
0000000000000000
0000000000000000
0000000000000000
0000000000000000
0000000006000000
0000000001000000
0000000000000000
0000000000000000
0000000001000000
0000000000000000
0000000000000000
0000000001000000
0000000000000000
0000000000000000
0000000001000000
0000000000000000
0000000000000000
0000110001000000
2000000000000050
1133333333333111


