0000000000000000
0000000000000000
0000000000000000
0000000000000000
0000300030003000
0000100010001000
0000100010001000
0000100010001000
0000107010001000
0000111113331000
0000100000000000
0000100000000000
0000100000000000
0000000000000000
0000000000000000
0030000000000000
0010000000000000
0010000000000000
6010000000000005
1110000000000311
0000000000003111
0000000000031111
2000033333311111
1111111111111111


