1111111111111111
1000000000000001
1000000000000001
1000000000040001
1000000000011001
1000000000000001
1000000000000001
1000000000000001
1000000000000001
1001000000000001
1000111100000001
1000000111000001
1000000001100001
1000000000110001
1000000000011001
1111100000001331
0000100000000111
0000111000000000
0000000000000000
0000000000000000
0000000001000000
0000001000000000
2001000000000000
1110000000000000


