0000000000000000
0000000000000000
0000000000000000
0000000000000000
0000000000000000
0000000000000000
0000000000000000
0000800800800600
0000000000000000
0000000000000000
0000000000000000
0000800000000000
0000000000000000
0000000000000000
0000800000000800
0000000000000000
0000003333333330
0008001000000000
0000001000000000
0000001000000000
0008001005000000
0000001001008008
2000001000000000
1113331333333333